#######
# @    #
%%%   #
#     #    
#     
#     #
######

   &