#######
# @    #
%%%   #
#     #    
&
#     #
#     #
######

   